
F 25,0111,4
C 65,5,8
SO dsad
NO dsa
WE dff

EA gfg

111111
111111
11111
11N1
1111110